1111111111111
1C0100C010011
1100011111P01
1C0011E0000C1
1111111111111
